Abchasisch|ab|abk|abk|abk
Afar|aa|aar|aar|aar
Afrikaans|af|afr|afr|afr
Akan|ak|aka|aka|aka
Albanisch|sq|sqi|alb|sqi
Amharisch|am|amh|amh|amh
Arabisch|ar|ara|ara|ara
Aragonesisch|an|arg|arg|arg
Armenisch|hy|hye|arm|hye
Assamesisch|as|asm|asm|asm
Avarisch|av|ava|ava|ava
Avestisch|ae|ave|ave|ave
Aymara|ay|aym|aym|aym
Aserbaidschanisch|az|aze|aze|aze
Bambara|bm|bam|bam|bam
Baschkirisch|ba|bak|bak|bak
Baskisch|eu|eus|baq|eus
Weißrussisch|be|bel|bel|bel
Bengalisch|bn|ben|ben|ben
Bihari|bh|bih|bih|
Bislama|bi|bis|bis|bis
Bosnisch|bs|bos|bos|bos
Bretonisch|br|bre|bre|bre
Bulgarisch|bg|bul|bul|bul
Birmanisch|my|mya|bur|mya
Katalanisch, Valencianisch|ca|cat|cat|cat
Chamorro|ch|cha|cha|cha
Tschetschenisch|ce|che|che|che
Chichewa|ny|nya|nya|nya
Tschuwaschisch|cv|chv|chv|chv
Kornisch|kw|cor|cor|cor
Korsisch|co|cos|cos|cos
Cree|cr|cre|cre|cre
Kroatisch|hr|hrv|hrv|hrv
Tschechisch|cs|ces|cze|ces
Dänisch|da|dan|dan|dan
Dhivehi|dv|div|div|div
Niederländisch, Belgisches Niederländisch|nl|nld|dut|nld
Dzongkha|dz|dzo|dzo|dzo
Englisch|en|eng|eng|eng
Esperanto|eo|epo|epo|epo
Estnisch|et|est|est|est
Ewe|ee|ewe|ewe|ewe
Färöisch|fo|fao|fao|fao
Fidschi|fj|fij|fij|fij
Finnisch|fi|fin|fin|fin
Französisch|fr|fra|fre|fra
Fulfulde|ff|ful|ful|ful
Galicisch, Galegisch|gl|glg|glg|glg
Georgisch|ka|kat|geo|kat
Deutsch|de|deu|ger|deu
Griechisch|el|ell|gre|ell
Guaraní|gn|grn|grn|grn
Gujarati|gu|guj|guj|guj
Haitianisch|ht|hat|hat|hat
Hausa|ha|hau|hau|hau
Hebräisch|he|heb|heb|heb
Otjiherero|hz|her|her|her
Hindi|hi|hin|hin|hin
Hiri Motu|ho|hmo|hmo|hmo
Ungarisch|hu|hun|hun|hun
Interlingua|ia|ina|ina|ina
Indonesisch|id|ind|ind|ind
Interlingue|ie|ile|ile|ile
Irisch|ga|gle|gle|gle
Igbo|ig|ibo|ibo|ibo
Inupiaq|ik|ipk|ipk|ipk
Ido|io|ido|ido|ido
Isländisch|is|isl|ice|isl
Italienisch|it|ita|ita|ita
Inuktitut|iu|iku|iku|iku
Japanisch|ja|jpn|jpn|jpn
Javanisch|jv|jav|jav|jav
Grönländisch, Kalaallisut|kl|kal|kal|kal
Kannada|kn|kan|kan|kan
Kanuri|kr|kau|kau|kau
Kashmiri|ks|kas|kas|kas
Kasachisch|kk|kaz|kaz|kaz
Khmer|km|khm|khm|khm
Kikuyu|ki|kik|kik|kik
Kinyarwanda, Ruandisch|rw|kin|kin|kin
Kirgisisch|ky|kir|kir|kir
Komi|kv|kom|kom|kom
Kikongo|kg|kon|kon|kon
Koreanisch|ko|kor|kor|kor
Kurdisch|ku|kur|kur|kur
oshiKwanyama|kj|kua|kua|kua
Latein|la|lat|lat|lat
Luxemburgisch|lb|ltz|ltz|ltz
Luganda|lg|lug|lug|lug
Limburgisch, Südniederfränkisch|li|lim|lim|lim
Lingála|ln|lin|lin|lin
Laotisch|lo|lao|lao|lao
Litauisch|lt|lit|lit|lit
Kiluba|lu|lub|lub|lub
Lettisch|lv|lav|lav|lav
Manx, Manx-Gälisch|gv|glv|glv|glv
Mazedonisch|mk|mkd|mac|mkd
Malagasy, Malagassi|mg|mlg|mlg|mlg
Malaiisch|ms|msa|may|msa
Malayalam|ml|mal|mal|mal
Maltesisch|mt|mlt|mlt|mlt
Maori|mi|mri|mao|mri
Marathi|mr|mar|mar|mar
Marshallesisch|mh|mah|mah|mah
Mongolisch|mn|mon|mon|mon
Moldauisch|mo|mol|mol|mol
Nauruisch|na|nau|nau|nau
Navajo|nv|nav|nav|nav
Nord-Ndebele|nd|nde|nde|nde
Nepali|ne|nep|nep|nep
Ndonga|ng|ndo|ndo|ndo
Bokmål|nb|nob|nob|nob
Nynorsk|nn|nno|nno|nno
Norwegisch|no|nor|nor|nor
Yi|ii|iii|iii|iii
Süd-Ndebele|nr|nbl|nbl|nbl
Okzitanisch|oc|oci|oci|oci
Ojibwe|oj|oji|oji|oji
Kirchenslawisch, Altkirchenslawisch|cu|chu|chu|chu
Oromo|om|orm|orm|orm
Oriya|or|ori|ori|ori
Ossetisch|os|oss|oss|oss
Panjabi, Pandschabi|pa|pan|pan|pan
Pali|pi|pli|pli|pli
Persisch|fa|fas|per|fas
Polnisch|pl|pol|pol|pol
Paschtunisch|ps|pus|pus|pus
Portugiesisch|pt|por|por|por
Quechua|qu|que|que|que
Bündnerromanisch, Romanisch|rm|roh|roh|roh
Kirundi|rn|run|run|run
Rumänisch|ro|ron|rum|ron
Russisch|ru|rus|rus|rus
Sanskrit|sa|san|san|san
Sardisch|sc|srd|srd|srd
Sindhi|sd|snd|snd|snd
Nordsamisch|se|sme|sme|sme
Serbokroatisch|sh||"(scc| scr)"|hbs
Samoanisch|sm|smo|smo|smo
Sango|sg|sag|sag|sag
Serbisch|sr|srp|srp|srp
Schottisch-gälisch|gd|gla|gla|gla
Shona|sn|sna|sna|sna
Singhalesisch|si|sin|sin|sin
Slowakisch|sk|slk|slo|slk
Slowenisch|sl|slv|slv|slv
Somali|so|som|som|som
Sesotho, Süd-Sotho|st|sot|sot|sot
Spanisch, Kastilisch|es|spa|spa|spa
Sundanesisch|su|sun|sun|sun
Swahili|sw|swa|swa|swa
Siswati|ss|ssw|ssw|ssw
Schwedisch|sv|swe|swe|swe
Tamil|ta|tam|tam|tam
Telugu|te|tel|tel|tel
Tadschikisch|tg|tgk|tgk|tgk
Thai|th|tha|tha|tha
Tigrinya|ti|tir|tir|tir
Tibetisch|bo|bod|tib|bod
Turkmenisch|tk|tuk|tuk|tuk
Tagalog|tl|tgl|tgl|tgl
Setswana|tn|tsn|tsn|tsn
Tongaisch|to|ton|ton|ton
Türkisch|tr|tur|tur|tur
Xitsonga|ts|tso|tso|tso
Tatarisch|tt|tat|tat|tat
Twi|tw|twi|twi|twi
Tahitianisch, Tahitisch|ty|tah|tah|tah
Uigurisch|ug|uig|uig|uig
Ukrainisch|uk|ukr|ukr|ukr
Urdu|ur|urd|urd|urd
Usbekisch|uz|uzb|uzb|uzb
Tshivenda|ve|ven|ven|ven
Vietnamesisch|vi|vie|vie|vie
Volapük|vo|vol|vol|vol
Wallonisch|wa|wln|wln|wln
Walisisch|cy|cym|wel|cym
Wolof|wo|wol|wol|wol
Westfriesisch|fy|fry|fry|fry
isiXhosa|xh|xho|xho|xho
Jiddisch|yi|yid|yid|yid
Yoruba|yo|yor|yor|yor
Zhuang|za|zha|zha|zha
Chinesisch|zh|zho|chi|zho
isiZulu|zu|zul|zul|zul